//0 = nothing
//1 = wall
//2 = spawn
//3 = crispyWall
1 1 1 1 1 1 1 1 1
1 2 0 0 0 0 0 0 1
1 0 1 3 1 3 1 0 1
1 0 3 0 3 0 3 0 1
1 0 1 3 1 3 1 0 1
1 0 3 0 3 0 3 0 1
1 0 1 3 1 3 1 0 1
1 0 0 0 0 0 0 0 1 
1 1 1 1 1 1 1 1 1