//0 = nothing
//1 = wall
//2 = spawn
1 1 1 1 1 1 1 1
1 2 0 0 0 0 0 1
1 0 1 0 0 1 0 1
1 0 0 0 0 0 0 1
1 0 1 0 0 1 0 1
1 0 0 0 0 0 0 1
1 1 0 0 0 0 0 1 1 1 1 1
1 0 0 0 0 0 0 1 1 1
1 1 1 1 1 1 1 1
1 1 1 1 1 1 1 1
1 1 1 1 1 1 1 1